......#......
.....###.....
....#####....
...#######...
..#########..
.#####.#####.
#####...#####
.#####.#####.
..#########..
...#######...
....#####....
.....###.....
......#......

0,6 12,6
6,0 6,12
